9
165 130 8 -1
165 130 7 -1
165 130 6 -1
165 130 5 -1
165 130 4 -1
165 130 3 -1
165 130 2 -1
165 130 1 -1
165 130 0 -1
0
